NO ./path_to_the_north_texture
SO ./path_to_the_south_texture
WE ./path_to_the_west_texture
EA ./path_to_the_east_texture

F 205,162,107
C 0,0,100

11111
10001
10001
10101
100N1
10001
11111